##################################################
#                                                #
#                                                #
#     *****                           *****      #
#     *Ap *                           *Wn *      #
#     *****                           *****      #
#                                                #
#                                                #
#                                                #
#                                                #
#                                                #
#                                                #
##################################################
