##################################################
#                                                #
#                                                #
#     *****           *****                      #
#     *Ap *           *Bp *                      #
#     *****           *****                      #
#                                                #
#                                                #
#                                                #
#########################                  ***** #
#                                          *Wn * #
#                                          ***** #
#                                                #
#                                                #
#       *****                  *****       ***** #
#       *Ze *                  *Ye *       *Xn * #
#       *****                  *****       ***** #
#                                                #
##################################################
