##################################################
#                                     #          #
#                                     #          #
#     *****           *****           #          #
#     *Ap *     #     *Cp *           #          #
#     *****     #     *****                      #
#               #                                #
#               #                                #
#               #             ######             #
#########################     ######       ***** #
#          #                    #          *We * #
#          #                    #          ***** #
#          #                                     #
#                                                #
#       *****                  *****       ***** #
#       *Zf *          #       *Nn *       *Xn * #
#       *****          #       *****       ***** #
#                      #                         #
##################################################
