##################################################
#                                     #          #
#                                     #   *****  #
#     *****           *****           #   *Qf *  #
#     *Ap *     #     *Cp *           #   *****  #
#     *****     #     *****                      #
#               #                                #
#               #              ###################
#               #             ######             #
#      #############################       ***** #
#          #                    #          *We * #
#          #                    #          ***** #
#          #                                     #
#                                                #
#       *****                  *****       ***** #
#       *Zf *          #       *Ng *       *Xg * #
#       *****          #       *****       ***** #
#                      #                         #
##################################################
