##################################################
#               #                     #          #
#               #                     #          #
#     *****     #     *****           #          #
#     *Ap *     #     *Ce *           #          #
#     *****     #     *****                      #
#               #                                #
#               #                                #
#               #             ####################
############    #########     ######       ***** #
#          #                    #          *Wg * #
#          #                    #          ***** #
#          ##############                        #
#                                                #
#       *****                  *****       ***** #
#       *Zf *          #       *Ng *       *Xg * #
#       *****          #       *****       ***** #
#                      #                         #
##################################################
