##################################################
#                                     #          #
#                                     #          #
#     *****           *****           #          #
#     *Af *     #     *Cg *           #          #
#     *****     #     *****                      #
#               #                                #
#               #                                #
#               #             ######             #
#########################     ######       ***** #
#          #                    #          *We * #
#          #                    #          ***** #
#          #                                     #
#                                                #
#       *****                  *****       ***** #
#       *Zf *          #       *Nn *       *Xe * #
#       *****          #       *****       ***** #
#                      #                         #
##################################################
