####################################################################################################
#                    ################################                                              #
#                    ################################                                              #
#     *****          ### ####                ########                                              #
#     *Nf *          ### ####                ########         ###########################          #
#     *****          ### ####   *****        ########         ###########################          #
#                    ### ####   *Ap *        ########         ###########################          #
#                    ### ####   *****        ########         ###### ####################          #
################     ### ####                ########         ######  ###################          #
################     ####                    ########         ######               ######          #
################     ########                ########         ######   *****       ######          #
#                    ##################### ##########         ######   *Jf *       ######          #
#                    ##################### ##########         ######   *****       ######          #
#                    ########                                #######               #######         #
#      ######################                               ############## ################        #
#      ######################                              ################ ################       #
#      ######################                             ################## ################      #
#                    ########                            ###########               ###########     #
#                    ########       *****               ############               ############    #
#                    ########       *Qe *              #############               #############   #
###############      ########       *****             ##############               ##############  #
###############      ########                        ###############               ##############  #
###############      ########                        ###############               ##############  #
#                    ########                        ###############               ##############  #
#                                                    ########                            ########  #
#     *****                                          #######                             ########  #
#     *Bp *    ############################          ######      #########  #########    ########  #
#     *****    ############################          #####       #########  #########    ########  #
#              ############################                      #########  #########              #
#              #######              #######                      #######      #######              #
####    ##############              #######                      #######      #######              #
####    ##############              #######                      ######  ***** ######              #
#                                   #######                      ######  *Kp * ######              #
#                ##########################                      ######  ***** ######              #
#                ##########################                      ######        ######              #
#                #######                        *****            ####################              #
#       *****    #######                        *Mn *                                              #
#       *Ge *    ##########################     *****                                              #
#       *****    ##########################                                                        #
#                ##########################                                                        #
####################################################################################################
