##########################################################################################################################################################
#                    ################################                                                               ##############                       #
#                    ################################                                             *****             ##############            *****      #
#     *****          ### ####                ########                                             *Pf *             ##############            *Ke *      #
#     *Nf *          ### ####                ########         ###########################         *****                                       *****      #
#     *****          ### ####   *****        ########         ###########################                ####################################            #
#                    ### ####   *Ap *        ########         ###########################                ###########              ###########            #
#                    ### ####   *****        ########         ###### ####################                ###########              ###########            #
################     ### ####                ########         ######  ###################                ###########     *****    ###########            #
################     ####                    ########         ######               ######                ###########     *Uf *    ###########            #
################     ########                ########         ######   *****       ######                                *****                           #
#                    ##################### ##########         ######   *Jf *       ######                                                                #
#                    ##################### ##########         ######   *****       ######                                                                #
#                    ########                                #######               #######                     ### ###              ### #####            #
#      ######################                               ############## ################                  ##### ######         ##### #######          #
#      ######################                              ################ ################                ###### ########     ####### ########         #
#      ######################                             ################## ################              ######*****######   ######*****#######        #
#                    ########                            ###########               ###########            #######*Ig *####### #######*Cg *########       #
#                    ########       *****               ############               ############           #######*****###############*****########       #
#                    ########       *Qe *              #############               #############          ########################################       #
###############      ########       *****             ##############               ##############         #################*****##################       #
###############      ########                        ###############               ##############           ###############*Zg *################  ###    #
###############      ########                        ###############               ##############          #  #############*****##############  #####    #
#                    ########                        ###############               ##############     ####  #    ############# #############   ######    #
#                                                    ########                            ########     #####  ##   ########### ##########    #######      #
#     *****                                          #######                             ########     #####   ###    ######## #######    ##########      #
#     *Bp *    ############################          ######      #########  #########    ########     #####   ######    ##### #####   ######             #
#     *****    ############################          #####       #########  #########    ########     #######   ########  ### ###   ########             #
#              ############################                      #########  #########                 #######   ##########  # #   ####                   #
#              #######              #######                      #######      #######                 #######   ###########     ######   *****           #
####    ##############              #######                      #######      #######                 #######   ######################   *Rp *           #
####    ##############              #######                      ######  ***** ######                 #######                            *****           #
#                                   #######                      ######  *Kp * ######                 #######                                            #
#                ##########################                      ######  ***** ######                 #######                                            #
#                ##########################                      ######        ######     *****       #######        #####################################
#                #######                        *****            ####################     *Op *       #######        #####################################
#       *****    #######                        *Mn *            #####          #####     *****       #######        #####################################
#       *Ge *    ##################### ####     *****            #####          #####                 #######                               ##############
#       *****    ###########        ## ####                      #####          #####                 #######                               ##############
#                ###########  ##### ## ####                      #####          #####                 #######                               ##############
#                ######          ## ## ####                                                                ##                               ##############
#                ###### ######## ## ## ################################################################################################     #### ***** ###
#                ###### ######## ##    ################################################################################################     #### *We * ###
#                ###### ######## ##### ################################################################################################     #### ***** ###
#                ###### ######## ##### ################################################################################################     ####       ###
#                ###### ######## ##### ####            ###########                                                                          ####  ########
#                ###### ######## ##### ####            ###########   *****                                                                        ########
#        *****   ###### ######## ##########            ###########   *Xp *                                                                  ##############
#        *Hg *   ###### ######## ##########  *****     ###########   *****    ###########################################################   ##############
#        *****          ########             *En *     ###########                         *****         ################################   ##############
#                ##########################  *****     ###########                         *Yg *                                            ##############
#                ##########################            ###########                         *****         #################################################
#                ##########################                                                              #################################################
##########################################################################################################################################################
