####################################################################################################
#                    ################################                                              #
#                    ################################                   *****             *****    #
#     *****          ### ####                ########                   *Rr *             *Uu *    #
#     *Nf *          ### ####                ######## *****   ######### ***** ########### *****    #
#     *****          ### ####   *****        ######## *Wj *   #########       ###########          #
#                    ### ####   *Ah *        ######## *****   ###########################          #
#                    ### ####   *****        ########         ###### ####################          #
################     ### ####                ########         ######  ################### *****    #
################     ####                    ########         ######               ###### *Tt *    #
################     ########                ########         ######   *****       ###### *****    #
#                    ##################### ##########         ######   *Jf *       ######          #
#                    ##################### ##########         ######   *****       ######          #
#                    ########                                #######               #######         #
#      ######################           *****               ############## ################        #
#      ######################           *Ho *              ################ ################       #
#               #############           *****             ################## ################      #
#  *****             ########                            ###########               #####           #
#  *Ek *             ########       *****               ############   *****       #####   *****   #
#  *****             ########       *Qe *                       ####   *Lm *        ###### *Zz *   #
###############      ########       *****                       ####   *****       ####### *****   #
###############      ########                   *****           ####               ##############  #
###############      ########                   *Ss *           ####               ##############  #
#                    ########                   *****           ####               ##############  #
#                                                                                        ########  #
#     *****                                          #######                             ########  #
#     *By *    ############ ***** #########          ######      #########  #########    ########  #
#     *****    ############ *Gr * #########          #####       #########  #########    ########  #
#              ############ ***** #########                      #########  #########              #
#              #######              #######              *****   #######      #######              #
####    ##############              #######              *Mq *   #######      #######              #
####    ##############              #######   *****      *****   ######  ***** ######              #
#                                   #######   *Qi *              ######  *Kx * ######              #
#                #################       ##   *****              ######  ***** ######  *****       #
#                ################# ***** ##                      ######        ######  *Rl *       #
#                #######           *Ww *        *****            ####################  *****       #
#       *****    #######           *****        *Mn *               *****                          #
#       *Ge *    ##########################     *****               *Yy *                          #
#       *****    ##########################                         *****                          #
#                ##########################                                                        #
####################################################################################################
